to burst = platzen, bersten
dissipation = Verschwendung
grain = Korn
inherent = eigen
inherently = von Natur aus
to strive = streben
to persuade = überzeugen
marvellous = fabelhaft, großartig, fantastisch, herrlich, wundervoll, wunderbar
precious = wertvoll
extensive = umfangreich, weitreichend, ausgiebig
permissive = freizügig, antiautoritär
revised = überarbeitet
faithfulness = Treue
faith = Vertrauen, Glauben, Treue
expressive = ausdrucksvoll, ausdrucksstark
to elaborate smth = etwas ausführen, etwas erarbeiten, ausführlich, etwas ausbauen
obsolete = veraltet
immaculate = makellos
to exaggerate = übertreiben
evanescent = abklingend
furthermore = zudem
to perceive = wahrnehmen
to denounce smth = etwas anprangern
to finance yourself = sich finanzieren
to mitigate = (etwas) mindern, (etwas) lindern, (etwas) mildern
invariant = unveränderlich, unvariabel
mandatory = verpflichtend, zwingend, unerlässlich, verbindlich, vorgeschrieben
to dispose = entsorgen
resumption = Wiederaufnahme
receptive = empfänglich
unintelligible, incomprehensible = unverständlich
to tarnish = trüben
disingenuous = unaufrichtig, unehrlich
seizure = Anfall
abducted = entführt
exhibition = Ausstellung
are to be = sollen sein
comprehensive = umfassend, umfangreich, ausführlich
merely = nur, lediglich, bloß
to emerge = entstehen, auftauchen, aufkommen
strained = angespannt
apprehensive = besorgt
sufficient = ausreichend
recess = Nische
to endorse smth, to advocate smth = etwas befürworten
conduct, behavior = Verhalten
depravity = Verkommenheit
testamonie = Zeugnis, Aussage, Zeugenaussage
rather than = lieber als, besser als
sustainable = nachhaltig
to conceive = begreifen, in Erwägung ziehen, konzipieren, vorstellen
leap = sprung
hence = daher, deshalb, also
culmination, peak = höhepunkt
to dismantle = auseinandernehmen
synthetic = künstlich
commerce = Handel
to adhere to something = sich an etwas halten
to alliviate smth = etwas mildern, etwas lindern
to cease = aufhören, unterlassen, einstellen
in spite of smth = trotz etwas
to decept sb = jemanden täuschen
to distract sb = jemanden ablenken
conceited = eingebildet, eitel
reluctant = ungern, (wiederstrebig - check!), widerwillig
shallow = flach
thus = so, somit, folglich, daher
novelty = neuheit
vivid = lebendig
endure = ertragen, aushalten, überdauern
to convey = übermitteln, vermitteln
accommodate = unterbringen
musing = Nachdenken
perpetuate = verewigen, aufrechterhalten
grudging = widerwillig, missgünstig
adversity = Unglück, Ungunst
erratic = unberechenbar, unregelmäßig
twisted, winded = verdreht, verbogen
inferior = minderwertig, unterlegen, schlechter
vicinity = Nähe
capricious = launisch
anticipated = erwartet
facility = Einrichtung, Leichtigkeit
deliberately = bewusst, absichtlich, vorsätzlich, wissentlich
ludicrous, ridiculous = lächerlich, lachhaft, grotesk
to condemn = verurteilen, verwerfen
raisin = Rosine
to riot = randalieren
conceivable = denkbar, vorstellbar, erdenklich
modest, humble = bescheiden
to segregate = trennen, absondern
pursue = verfolgen
repelled = abgestoßen, abgewehrt, vertrieben
resentful = verärgert, nachtragend
indignation = Empörung
intrusion = Einbruch
inconvenience = Unannehmlichkeit
dignity = Würde
to avoid = vermeiden
inception = Anfang
lest = damit nicht
abandoned = verlassen, verwaist
eagerly = eifrig
to be used to a purpose = für einen Zweck genutzt werden
appliance = Haushaltsgerät
to incinerate smth = etwas verbrennen
to adhere to smth = an etwas festhalten, etwas einhalten
due = fällig
occupied = belegt, besetzt, bewohnt, beschäftigt
to accommodate smth = etwas unterbringen
stubborn = stur
to emphasize = betonen, hervorheben, unterstreichen
applicable = anwendbar
course = Kurs, Ablauf, Lauf, Gang
besides = zusätzlich zu(in addition to), zudem
stove = Herd
cease and desist order = Unterlassungsverfügung
cheek = Wange, Backe
confiscated = beschlagnahmt, konfisziert
bra = BH
hedgehog = Igel
cleaver = Hackmesser
conservative = vorsichtig, erhaltend, konservativ
crayons = (Bunt)stifte, Kreide(n)
filing cabinet = Aktenschrank
snorting = schnaubend, schnüffelnd
eavesdrop = (be)lauschen
to tickle = kitzeln
municipality = Gemeinde
frontier = Grenze
slope, gradient, descent = Steigung
atrocious = scheußlich, grauenhaft, entsetzlich, fürchterlich, abscheulich
wielding = schwingen(d)
to wield = schwingen
hindsight = Rückblickend, Rückblick, Rückschau
heinsight = Einsicht, Einblick
subtle = subtil, unscheinbar
abyss = Abgrund
jurisdiction = Zuständigkeit
fuss = Aufregung
vital = (lebens)wichtig, notwendig, unerlässlich
oh dear = ach je
anguish = Pein, Qual, Angst
aspiration = Streben, Ziel, Bestrebung
tremendously = enorm, massiv, außerordentlich, immens
fallacious = trügerisch
blatantly = offensichtlich, unverhohlen, unverfroren, eklatant
downright = regelrecht, geradezu
envy = Neid
inconsistencies = Ungereimtheiten, Unstimmigkeiten, Widersprüche
burden = Last, Belastung(en), Bürde
welfare = Wohlergehen, Wohlfahrt
suitably = angemessen
captivated, tied up, spellbound = gefesselt
sentient = empfindungsfähig
to dissect = zerlegen
trivia = Nichtigkeiten
dorm = Wohnheim
real estate = Immobilien
contemplating = Nachdenken
allowance = Zulage, Geldzuwendung
rascous = schelmisch
ascounding = aufsteigend
to devour = verschlingen
abundantly = reichlich, im Überfluss, in Hülle und Fülle
toddler = Kleinkind
to console = trösten
esteem = Wertschätzung, Achtung, Ansehen
to esteem = schätzen, wertschätzen
conceited = eingebildet
itchy = juckend, kratzig
to rehearse = proben, einüben
to forecast = vorhersagen
presumable = vermutlich
foresight = Voraussicht, Weitblick
to infer = schließen, folgern, ableiten
tethered = angebunden, gefesselt
to amend = zu ändern, berichtigen, verbessern
condescending = herablassend
to huddle = kauern
a straw = ein Strohhalm
morbid = krankhaft
to facilitate = erleichtern
altercation = Auseinandersetzung, Streit
malevolence = Böswilligkeit
to transcend = übertreffen
commodity = Ware, Rohstoff, Artikel
prevail, to assert oneself = sich durchsetzen
spurious = falsch, unberechtigt, nicht echt
negligible = vernachlässigbar
felony, offence, offense = Verbrechen, Straftat(bestand)
curable = heilbar
to unsert = deaktivieren
expenditure = Aufwand, Ausgaben, Kosten
(to )denote = bezeichnen, bedeuten, kennzeichnen
(to )shove = stopfen, drängen, schieben, stoßen, schubsen
(to )restrain = zurückhalten, unterdrücken, einschränken
imminent = (unmittelbar) bevorstehend
prospect = Aussicht, Ausblick, Perspektive
indecisive = unentschlossen, unentschieden
brevity = Kürze
juristiction = Zuständigkeit
recidivism = Rückfälligkeit
coercive = Zwang, Nötigung
rearing = Aufzucht
to commence = beginnen, anfangen, starten
to deceive someone = jemanden täuschen
conscientious = gewissenhaft
to consult = befragen
contemporary = zeitgenössisch
viscous = dickflüssig
reed = Schilf
prohibition = Verbot
cunning = List, listig
to apprehend = festnehmen
to dismember = zerstückeln
Jünger = disciple(s)
to indulge = verwöhnen
to deduce = ableiten
vengeance = Rache
flattering = Schmeicheln
dangling = baumelnd, hängend
depletion = Erschöpfung
seditious = Aufrührisch
feral = wild, verwildert
gratitude = Dankbarkeit
shattered = zerschlagen, zerschmettered, erschüttert
receded = zurückgetreten, geschwunden
to heed = beachten
to prosper = gedeihen
pretence = Schein, Vortäuschung, Heuchelei
treason = (Landes)(Hoch)Verrat
dwindle = schwinden
intendance = Absicht
detention = Nachsitzen, Inhaftierung, Festnahme, Ingewahrsamnahme
to devote = hingeben
to disown = verleugnen
dissidence = Wiederstand, Uneinigkeit
to vindicate = (sich) rechtfertigen
strenuous = anstrengend, kräftezehrend, mühsam
to object = einwenden, widersprechen, beanstanden, protestieren, (gegen etwas) Einspruch erheben
estranged = zerstritten, entfremdet
retribution = Vergeltung, Strafe
diligent = fleißig, gewissenhaft, sorgfätig
to advocate((sb)(smth)) = (etwas)(jemanden)(jmnd(.))(etw(.))befürworten, sich für (etwas)(jemand(en)) einsetzen
to abolish = abschaffen
steep = steil
to pave = pflastern
disrepair, expiry, decline = Verfall
to charge sb with smth = jemanden mit etwas beschuldigen
indent = eingerückt
hindsight = Rücksicht
composure = Gelassenheit
arousal = Erregung
divulgence = Offenlegung, Bekanntmachung, Verbreitung
freight = Fracht
compulsory = verpflichtend
wrath = Zorn
sloth = Faulheit, Faultier, Trägheit
envy = Neid
feasible = möglich, machbar, durchführbar, realisierbar
arbitrary = willkürlich, beliebig
nimble = flink
coercion = Zwang
detrimental = schädlich, nachteilig
gregarious = gesellig
abomination = Gräuel, Abscheulichkeit
to proceed with something = mit etwas fortfahren
employer = Arbeitgeber
warranted = garantiert, gewährleistet, gerechtfertigt, berechtigt
very short = brief
very good = superb
very cold = freezing
very hungry = ravenous
very slow = sluggish
very fast = rapid
pace = geschwindigkeit
very tired = exhausted
very rich = wealthy
very clean = spotless
very happy = jubilant
very (dry)/thristy -> parched
mutually = gegenseitig, beidseitig
defecate = Stuhlgang
hospitality = Gastfreundschaft
ingenious = genial
acquaintances = Bekannte
to assess something = etwas einschätzen
convoluted = verworren, gewunden
clinging = klammernd, haftend
devolved = verteilt
to substantiate something = etwas begründen
endearing = liebenswert
gratification = Befriedigung, Belohnung, Genugtuung, Erfüllung, Vergütung
indicted = angeklagt
mercenary = Söldner
steady = stetig
womb = Gebärmutter
prelude = Auftakt
vicinity = Nähe
to postpone smth = etwas verzögern
affinity = etwas mögen
to herald from = auf etwas zeigen, etwas implizieren
signifier = Symbol
inadvertently = unabsichtlich, ausversehen
flawed, distorted = verunstaltet, entstellt
to dislodge smth, to displace smth = etwas entfernen
substantial = wesentlich, erheblich, reichhaltig
capacious = geräumig, umfassend
luminescent = leuchtend
shining = leuchtend
to foster = entwickeln, fördern, unterstützen, pflegen
to resemble smth = etwas gleichen, etwas ähneln
solstice = Sonnenwende
laces = Schnürsenkel
penitentary = Bußgelder, Büßer
hideous = abscheulich, scheußlich, furchtbar, gräßlich
bland = geschmacklos, fade
recreationally = freizeitlich
engulfment = Verschlingung
unwary = unachtsam
superfluous = überflüssig
self-effacing = selbstironisch
soreness = Schmerz
sore = weh
exude = verströmen, ausstrahlen
pesky = ärgerlich, lästig, nervig
calamity = Unglück, Unheil, Katastrophe
delinquent = Übeltäter
impetuous = impulsiv, ungestüm
impecunious = poor
refrain = unterlassen
abstain = Enthaltung, (sich )enthalten
accolade = Auszeichnung, Anerkennung, Lob, Ehrung
scorn = Verachtung, verachten, verschmähen
commiserate = bemitleiden, bedauern
conjecture = Vermutung, Mutmaßung
blend
gauche
rattled
crumbly
friable
furtive
insular
surplus
petty
furlough
surrogate
mercurial
sustenance
solicit
sovereignty
susceptible
subjugate
mandacious
unruly
obstreperous
denizen
diatribe
plethora
cathartic
aloof
austerity
impotent = machtlos
amenities
adamantine
expedient
etheral
imperative
dolorous
sorrowful
disparate
blunder
dissemble
frenetic = fieberhaft
cachet = Gütesiegel, prestige
spurious = falsch, fadenscheinig, störend, unberechtigt
glass of water = glas wasser
discord = Konflikt, Zwietracht, Diskurs, Missklang, Zwist
epiphany
revelation
immaculate
impeccable
illicit
sublime
edify
tutelage
addendum
abjure
mandate
numinous
sanction
superflous
melliflous
slough = (garten) schuppen
surrreptitious
sappy
maudlin
imminent = drohend, kurz bevorstehend
verisimilitude
untoward
veribiage
replete
traduce
(to )diffuse = zerstreuen, vermischen
engender
courtesy
discerning
desuetude
enamored = verliebt
condone = dulden, hinnehmen
fickle
concomitant
cupidity = Gier, Habgier
conciliatory = versöhnlich, beschwichtigend
feisty = lebhaft, angriffslustig, temperamentvoll
dissipate = zerstreuen, verbreiten, vergeuden, verschwenden
animus = Feindseligkeit
assent = Zustimmung, Einwilligung
inclement = unbarmherzig, unfreundlich, rau
copacetic = in bester Ordnung
aversion = Aversion, Abneigung
malevolent = böswillig, boshaft
derelict = frühreif
precocious
retribution = vergeltung, rache
insidious = hinterlistig, heimtückisch
treacherous = verräterisch, trügerisch, heimtückisch, hinterhältig
preclude = ausschließen
revelry = Festlichkeit(en), Fest
inimical = feindlich, nachteilig, widrig, hinderlich
prerogative = Vorrecht, Privileg
ineluctable = unvermeidlich, unausweichlich
reverence = Ehrfurcht, Verehrung, verehren
insinuate = unterstellen
to scold sb = mit jemandem schimpfen
reproach = Vorwurf
to reproach sb = jemandem Vorwürfe machen
indolent = faul, träge
ineffable = unbeschreiblich, unsagbar
to radiate = ausstrahlen, strahlen, abgeben
brawny = stark, muskulös
fuzzy = unscharf
indurate
inexorable = unaufhaltsam, unerbitterlich, erbarmungslos
resolution = Entschluss, Auflösung, Lösung
pertinent = relevant, sachbezogen, einschlägig, sachdienlich
precipice = Abgrund, Klippe, Steilhang
piety = Frömmlichkeit, Pietät, Religiosität
agony = Agonie, (Höllen)(Todes)Qual(en), Schmerz(en), Tortur, Leid(en)
humiliation = Demütigung, Erniedrigung
excruciating = unerträglich, quälend, schmerzhaft, qualvoll, entsetzlich
epiphany = Offenbarung, Erleuchtung
to curse = fluchen
curse = Fluch
eldritch = unheimlich, schauerlich, gespenstisch, überirdisch
crest = Wappen, Kamm, Krone, Gipfel, Bergrücken, Kuppe, Scheitel
formidable = beeindurckend, beachtlich, enorm
vexed = verärgert, leidig, bekümmert, gereizt
overt = offensichtlich, offenkundig, offen
reprecautions = Vorsichtsmaßnahmen
colluding = konspirierend
admittance = Zulassung, Eintritt, Aufnahme
instigate = anstiften, anzetteln, anregen, aufwiegeln
(to )abide = bleiben, wohnen, etw. ertragen, ausstehen
assailed = überfallen, angegriffen, gestürmt
receipt = (kassen)bon, Rechnung
appointment = Termin
capsize = kentern
enticing = verheißungsvoll
collar = Kragen, Halsband, Halskragen
consort = Begleitung, Gattin, Gemahlin
unobtrusively = unauffällig, unaufdringlich
canopy = Vordach, Überdachung, Betthimmel, Baldachin
lush = üppig, grün
menace = Bedrohung, Gefährdung
keen = scharf, begierig, eifrig, willig
firm = fest, entschieden
frantic = verzweifelt, hektisch, außer sich
superstitious = abergläubisch
eminent = hervorragend, herrausragend
unwitting = unwissentlich, unbewusst, unfreiwillig
pertains = bezieht sich auf, betrifft, gehört
enliving = belebend
to herald = zu verkünden, anzukündigen
edifice = Bauwerk, Gebäude
divested = entkleidet, veräußert, beraubt, ausgegliedert
myriad = Unzahl, Heerschar
misgivings = Befürchtungen, Bedenken, Vorbehalte, Besorgnisse